max_provinces = 3822

sea_starts = {
1 2 3 4 5 6 7 8 9 10 11 12 13 14 15 16 17 18 19 20 21 22 23 24 25 26 27 28 29 30 31 32 33 34 35 
36 37 38 39 40 41 42 43 55 58 61 62 63 69 74 78 81 84 85 101 104 107 113 122 124 126 128 129 135 136 141 142 143 144 146 
151 158 159 160 180 181 182 184 185 186 195 215 227 236 249 251 258 277 279 289 301 313 326 343 344 352 354 384 399 
411 417 418 424 432 435 443 454 456 459 464 508 522 546 561 562 602 614 649 653 681 691 724 736 737 745 748 764 773 778 
799 800 806 811 815 816 820 832 838 847 848 867 877 884 895 904 917 929 938 941 945 963 968 970 977 980 984 990 995 1001 
1006 1007 1023 1024 1025 1027 1030 1036 1052 1061 1065 1067 1070 1082 1084 1087 1088 1090 1108 1112 1116 1122 1123 1125 
1126 1140 1143 1145 1148 1149 1153 1155 1158 1165 1166 1170 1174 1176 1180 1183 1189 1192 1204 1206 1207 1211 1215 1218 
1223 1224 1225 1227 1230 1236 1238 1248 1256 1259 1262 1263 1266 1272 1275 1277 1278 1281 1286 1288 1301 1304 1311 1312 
1323 1331 1342 1355 1356 1359 1370 1378 1406 1411 1414 1418 1420 1439 1440 1442 1444 1468 1502 1540 1541 1548 1551 1554 
1557 1558 1561 1563 1588 1632 1659 1663 1670 1671 1676 1698 1707 1711 1715 1728 1744 1771 1808 1812 1879 1902 1915 1929 
1933 1944 1952 1958 1985 1989 1996 2007 2010 2017 2047 2061 2074 2083 2095 2116 2120 2121 2148 2160 2194 2203 2211 2212 
2217 2220 2228 2231 2274 2291 2300 2305 2352 2354 2358 2374 2390 2400 2402 2433 2435 2440 2459 2460 2467 2473 2504 2515 
2522 2528 2540 2545 2547 2580 2594 2596 2614 2616 2627 2635 2656 2659 2660 2667 2668 2676 2683 2687 2708 2733 2752 2755 
2769 2773 2775 2777 2810 2817 2844 2859 2873 2878 2880 2896 2913 2916 2917 2920 2921 2925 2941 2942 2959 2960 2965 
2989 2991 2997 3010 3022 3026 3043 3048 3049 3056 3057 3075 3076 3081 3082 3089 3105 3116 3118 3122 3127 3131 3142 3170 
3173 3174 3179 3180 3183 3204 3211 3212 3229 3242 3267 3268 3277 3285 3304 3309 3322 3338 3347 3348 3365 3368 3370 3380 
3381 3384 3414 3421 3432 3437 3442 3444 3446 3451 3463 3466 3470 3492 3493 3494 3512 3517 3522 3525 3542 3554 3559 3569 
3574 3583 3592 3594 3598 3603 3613 3642 3660 3666 3667 3668 3670 3681 3684 3685 3687 3702 3703 3713 3719 3721 3722 3727 
3729 3733 3737 3743 3746 3764 3766 3767 3772 3782 3788 3791 3792 3794 3796 3800 3801 3802 3803 3804 3805 3806 3807 3808 
3814 3817 3818 3819 3820 3821 
}

definitions = "../mod/celestia_2_dev/map/definition.csv"
provinces = "provinces.bmp"
positions = "positions.txt"
terrain = "terrain.bmp"
rivers = "rivers.bmp"
terrain_definition = "terrain.txt"
tree_definition = "trees.txt"
continent = "continent.txt"
adjacencies = "adjacencies.csv"
region = "region.txt"
region_sea = "region_sea.txt"
province_flag_sprite = "province_flag_sprites"


border_heights = {
	500
	800
	1100
}

terrain_sheet_heights = {
	500 #150
}

tree = 350

border_cutoff = 1100.0

