max_provinces = 3243

sea_starts = {
1 2 3 4 5 6 7 8 9 10 11 12 13 14 15 16 17 18 19 20 21 22 23 24 25 26 27 28 29 
30 31 32 33 34 35 36 37 38 47 49 51 52 53 58 63 67 71 72 85 90 96 104 106 108 
109 115 116 120 121 122 123 128 133 134 151 153 154 155 161 176 183 190 200 207 
225 228 247 266 278 286 288 311 323 332 337 338 344 350 352 370 373 377 414 
427 447 459 460 497 508 534 551 559 568 586 591 599 608 610 623 629 651 656 659 
663 671 676 680 681 696 704 710 718 729 740 746 749 753 768 770 778 782 787 789 
795 796 800 812 814 818 822 833 839 842 844 847 858 859 861 864 866 882 888 889 
891 904 907 909 913 914 918 920 923 930 931 935 940 941 945 952 954 966 968 969 
975 981 983 985 991 993 1003 1011 1014 1017 1018 1025 1028 1029 1031 1032 1039 
1041 1056 1063 1078 1081 1091 1104 1106 1115 1125 1139 1152 1157 1160 1163 1165 
1184 1185 1187 1189 1210 1242 1274 1280 1284 1287 1290 1315 1354 1375 1379 271
1385 1386 1390 1409 1420 1423 1424 1435 1450 1474 1484 1507 1511 1565 1585 1597 
1611 1615 1623 1630 1636 1660 1667 1676 1679 1683 1708 1733 1739 1765 1769 1770 
1790 1802 1830 1835 1840 1841 1846 1850 1856 1859 1895 1907 1920 1962 1966 1981 
1996 2004 2006 2032 2034 2057 2058 2064 2069 2092 2100 2106 2110 2119 2124 2126 
2153 2163 2165 2182 2184 2194 2199 2220 2223 2224 2230 2238 2245 2292 2326 2330 2332 
2334 2366 2372 2395 2408 2421 2426 2440 2457 2460 2461 2464 2465 2479 2480 2494 2501 2507 
2521 2527 2538 2548 2553 2569 2573 2579 2594 2595 2600 2601 2608 2623 2632 2636 2641 2645 2656 
2677 2680 2681 2685 2686 2689 2709 2714 2715 2729 2739 2759 2760 2768 2776 2791 2794 2804 2818 2826 
2841 2844 2846 2856 2857 2860 2884 2900 2905 2909 2911 2912 2917 2927 2929 2933 2955 2956 2957 2973 2977 
2981 2982 2994 3004 3008 3017 3021 3028 3037 3039 3043 3047 3057 3083 3100 3106 3107 3108 3110 3121 3124 
3125 3127 3141 3142 3151 3156 3158 3159 3164 3166 3168 3172 3175 3178 3195 3197 3198 3202 3211 3214 3216 3217 3218 3220 3223 3224 3225 3226 3227 3228 3229 3230 3231 3236 3238 3239 3240 3241 
}

definitions = "../mod/celestia_2_dev/map/definition.csv"
provinces = "provinces.bmp"
positions = "positions.txt"
terrain = "terrain.bmp"
rivers = "rivers.bmp"
terrain_definition = "terrain.txt"
tree_definition = "trees.txt"
continent = "continent.txt"
adjacencies = "adjacencies.csv"
region = "region.txt"
region_sea = "region_sea.txt"
province_flag_sprite = "province_flag_sprites"


border_heights = {
	500
	800
	1100
}

terrain_sheet_heights = {
	500 #150
}

tree = 350

border_cutoff = 1100.0

